################################################################################################################################
##______________________________________________________________________________________________________________________________
##______________________________________________________________________________________________________________________________
##______________________________________________________________________________________________________________________________
##______________________________________________________________________________________________________________________________
##______________________________________________________________________________________________________________________________
##______________________________________________________________________________________________________________________________
##______________________________________________________________________________________________________________________________
##______________________________________________________________________________________________________________________________
##______________________________________________________________________________________________________________________________
##_____________________________________________________________________________________________________________________________#
##______________________________________________________________________________________________________________________________
##______________________________________________________________________________________________________________________________
##______________________________________________________________________________________________________________________________
##______________________________________________________________________________________________________________________________
##______________________________________________________________________________________________________________________________
##______________________________________________________________________________________________________________________________
##______________________________________________________________________________________________________________________________
##______________________________________________________________________________________________________________________________
##______________________________________________________________________________________________________________________________
##______________________________________________________________________________________________________________________________
##______________________________________________________________________________________________________________________________
##____________________________________________________________________________________________________________________________##
##______________________________________________________________________________________________________________________________
##______________________________________________________________________________________________________________________________
##______________________________________________________________________________________________________________________________
##______________________________________________________________________________________________________________________________
##__________________________________________________________________________________________xxxxxxxxxxxxxxxxxxxxxxxxxxxxxxxxxxxx
################################################################################################################################
################################################################################################################################
################################################################################################################################
################################################################################################################################


################################################################################################################################
________________________________________________________________________________________##______________________________########
________________________________________________________________________________________##____O_________________________########
________________________________________________________________________________________##______________________________########
________________________________________________________________________________________##___###############^^^^^^^^^^^_########
________________________________________________________________________________________##___###############____________########
________________________________________________________________________________________##___###############________^^__########
________________________________________________________________________________________##___###############____________########
_________________________________________________#########################################___###############________^^__########
____________________________________________###_________________________________________<____###############____________########
#########################################_______________________________________________<____###############________^^__########
________________|_______________________#_______________________________________________####################____________########
________________|_______________________#__O____________________________________________####################________^^__########
________________|_______________________#_______________________________________________####################____________########
________________|_______________________######__######____#######____###________________####################________^^^^_______#
________________|_____________________________________________###____###____^^__________####################^^#^^^____###______#
_____________O__|_____________________________________________###____###________________##_____________#####__#_^^^^^^_________#
________________|______________________#______________________###____###_##________##___##_____________#####^^#^^^^____________#
____________###_|______________________#______________________###____###___________##___##_____________#####__#________________#
________________|__________x_______x___#______________________###____###____^^_____##___##_____________#####^^#________________#
________##______|______#######__####___#______________________###____###___________##___##_____________#####__#__________#_____#
________________|_____________________________________________###____###_______##__##___##_____________X####^^#__________#_____#
__###___________|___##_____________#####______O____________________________________##___######^^#####___X###_____________#_____#
________##______|____________________O______________________________________##_____##____|__________##___X##^^^^^^^^^^^__#_____#
________________|______##_____________________________####___####____####__________##____|____^^____###___X#___________^^#_____r
__________^^____|_____________##rrrrrrrrrrr##xxx##___________####____####__________##____|__________####______x__x__x____#fffff#
________________|__________##_##___________#########_________####____####__________#############################################
xxxxxxxxxx##____|______##__##_##xxxxxxxxxxx##_O_<<<<_______________________________#############################################
################################################################################################################################
################################################################################################################################
################################################################################################################################
################################################################################################################################

################################################################################################################################
######################################_____________________________#__________________________________##########################
######################################_____________________________#_O______________>_________________##########################
######################################_____________________________#______#____#___#>_________________##########################
######################################____________######___________#__________________##___##___##____##########################
######################################__________########___________####_____________####______________##########################
######################################________##########___________#______________________________##^^##########################
######################################_______###########___________#______________________________##__##########################
##############_______________________r_____#############___________#______________________________##^^##########################
#____________r_______________________r_________________#___________#vvvvvvvvvvvvvvvvvvvvvvvvvvvvvv##__##########################
#____________r_____^^^^^^^^^^^^^^#######################___________#________________________________^^##########################
#____________r___________________######_______________<R___________#______O___________________________##########################
##########_O_##########_______##_######_______f_______##&&&&&&&&&&&#________________________________^^##########################
#________________________r_____#______________________<R___________r__________________________________##########################
#_f_____________________r______#f######_______________##fffff##ffff############_^^_#############################################
#______________________r____f__##############RRR###############################____#############################################
#_____________________r________<__XXXX______<___###############################vvvv#############################################
####RRRrrrRRRrrrRRRrrrRRR______<____________<_O_########___|____XXXXX____|_________###_________________#########################
####XXXXXXXXXXXXXXXXXXXXXX_____<____________<___########___|_____________|_________###_________________#########################
#################################^^^^^^^^^^^____########___|______O______|_________###________E________#########################
###___________________________|_______________________RR___|_____________|_____________________________#########################
O##___________________________|____^^_________________RR___|_____________|_____________________________#########################
_##_________f____O____f_______|_______________________##__###RRRRRRRRRRR#######_^__#############################################
_##___________________________|____^^_________________##__###xxxxxxxxxxx#######____#############################################
_R____________________________|___________###RRR###___##__###___________#######_^__#############################################
f##fRRRRRRRR_rrrrrrrrr_RRRRRR#########________________##__###_____O_____XXXXXXX________________________#########################
####xxxxxxxxxxxxxxxxxxxxxxxxx#########________O_______##__###___________________^______________________#########################
######################################rrrrrrrrrrrrrrrr##xx###_____X____________________________________#########################
######################################xxxxxxxxxxxxxxxx##########################################################################
################################################################################################################################
################################################################################################################################
################################################################################################################################
