################################################################################################################################
##______________________________________________________________________________________________________________________________
##______________________________________________________________________________________________________________________________
##______________________________________________________________________________________________________________________________
##______________________________________________________________________________________________________________________________
##______________________________________________________________________________________________________________________________
##______________________________________________________________________________________________________________________________
##______________________________________________________________________________________________________________________________
##______________________________________________________________________________________________________________________________
##______________________________________________________________________________________________________________________________
##_____________________________________________________________________________________________________________________________#
##______________________________________________________________________________________________________________________________
##______________________________________________________________________________________________________________________________
##______________________________________________________________________________________________________________________________
##______________________________________________________________________________________________________________________________
##______________________________________________________________________________________________________________________________
##______________________________________________________________________________________________________________________________
##______________________________________________________________________________________________________________________________
##______________________________________________________________________________________________________________________________
##______________________________________________________________________________________________________________________________
##______________________________________________________________________________________________________________________________
##______________________________________________________________________________________________________________________________
##______________________________________________________________________________________________________________________________
##______________________________________________________________________________________________________________________________
##______________________________________________________________________________________________________________________________
##______________________________________________________________________________________________________________________________
##______________________________________________________________________________________________________________________________
##______________________________________________________________________________________________________________________________
################################################################################################################################
################################################################################################################################
################################################################################################################################
################################################################################################################################


################################################################################################################################
________________________________________________________________________________________####################____________#_______
________________________________________________________________________________________####################____________#_______
________________________________________________________________________________________####################____________#_______
________________________________________________________________________________________####################____________#_______
________________________________________________________________________________________####################____________#_______
________________________________________________________________________________________####################____________#_______
________________________________________________________________________________________####################____________#_______
_________________________________________________###########################################################____________#_______
____________________________________________###_________________________________________####################____________#_______
#########################################_______________________________________________####################____________#_______
________________|_______________________#_______________________________________________####################____________#_______
________________|_______________________#__O____________________________________________####################____________#_______
________________|_______________________#_______________________________________________####################____________#_______
________________|_______________________######__######____#######____###________________####################________^^^^________
________________|_____________________________________________###____###____^^__________####################^^#^^^____###_______
________________|_____________________________________________###____###________________##_____________#####__#_^^^^^^__________
________________|______________________#______________________###____###_##________##___##_____________#####^^#^^^^_____________
________________|______________________#______________________###____###___________##___##_____________#####__#_________________
________________|__________x_______x___#______________________###____###____^^_____##___##_____________#####^^#_________________
________________|______#######__####___#______________________###____###___________##___##_____________#####__#__________#______
________________|_____________________________________________###____###_______##__##___##_____________X####^^#__________#______
________________|___##_____________#####___________________________________________##___######^^#####___X###_____________#______
________________|___________________________________________________________##_____##____|__________##___X##^^^^^^^^^^^__#______
________________|______##_____________________________####____###____###___________##____|____^^____###___X#___________^^#______
________________|_____________##___________##xxx##____________###____###___________##____|__________####______x__x__x____#______
________________|__________##_##___________#########__________###____###___________#############################################
________________|______##__##_##xxxxxxxxxxx##_O____________________________________#############################################
################################################################################################################################
################################################################################################################################
################################################################################################################################
################################################################################################################################

________________________________________________________________________________________________________________________________
________________________________________________________________________________________________________________________________
________________________________________________________________________________________________________________________________
________________________________________________________________________________________________________________________________
________________________________________________________________________________________________________________________________
________________________________________________________________________________________________________________________________
________________________________________________________________________________________________________________________________
________________________________________________________________________________________________________________________________
________________________________________________________________________________________________________________________________
________________________________________________________________________________________________________________________________
________________________________________________________________________________________________________________________________
________________________________________________________________________________________________________________________________
________________________________________________________________________________________________________________________________
________________________________________________________________________________________________________________________________
________________________________________________________________________________________________________________________________
________________________________________________________________________________________________________________________________
________________________________________________________________________________________________________________________________
________________________________________________________________________________________________________________________________
________________________________________________________________________________________________________________________________
________________________________________________________________________________________________________________________________
________________________________________________________________________________________________________________________________
________________________________________________________________________________________________________________________________
________________________________________________________________________________________________________________________________
________________________________________________________________________________________________________________________________
________________________________________________________________________________________________________________________________
________________________________________________________________________________________________________________________________
#####################################___________________________________________________________________________________________
#####################################___________________________________________________________________________________________
################################################################################################################################
################################################################################################################################
################################################################################################################################
################################################################################################################################


________________________________________________________________________________________________________________________________
________________________________________________________________________________________________________________________________
________________________________________________________________________________________________________________________________
________________________________________________________________________________________________________________________________
________________________________________________________________________________________________________________________________
________________________________________________________________________________________________________________________________
________________________________________________________________________________________________________________________________
________________________________________________________________________________________________________________________________
________________________________________________________________________________________________________________________________
________________________________________________________________________________________________________________________________
________________________________________________________________________________________________________________________________
________________________________________________________________________________________________________________________________
________________________________________________________________________________________________________________________________
________________________________________________________________________________________________________________________________
________________________________________________________________________________________________________________________________
________________________________________________________________________________________________________________________________
________________________________________________________________________________________________________________________________
________________________________________________________________________________________________________________________________
________________________________________________________________________________________________________________________________
________________________________________________________________________________________________________________________________
________________________________________________________________________________________________________________________________
________________________________________________________________________________________________________________________________
________________________________________________________________________________________________________________________________
________________________________________________________________________________________________________________________________
________________________________________________________________________________________________________________________________
________________________________________________________________________________________________________________________________
________________________________________________________________________________________________________________________________
________________________________________________________________________________________________________________________________
################################################################################################################################
################################################################################################################################
################################################################################################################################
################################################################################################################################
