################################################################################################################################
##______________________________________________________________________________________________________________________________
##______________________________________________________________________________________________________________________________
##______________________________________________________________________________________________________________________________
##______________________________________________________________________________________________________________________________
##______________________________________________________________________________________________________________________________
##______________________________________________________________________________________________________________________________
##______________________________________________________________________________________________________________________________
##______________________________________________________________________________________________________________________________
##______________________________________________________________________________________________________________________________
##_____________________________________________________________________________________________________________________________#
##______________________________________________________________________________________________________________________________
##______________________________________________________________________________________________________________________________
##______________________________________________________________________________________________________________________________
##______________________________________________________________________________________________________________________________
##______________________________________________________________________________________________________________________________
##______________________________________________________________________________________________________________________________
##______________________________________________________________________________________________________________________________
##______________________________________________________________________________________________________________________________
##______________________________________________________________________________________________________________________________
##______________________________________________________________________________________________________________________________
##______________________________________________________________________________________________________________________________
##____________________________________________________________________________________________________________________________##
##______________________________________________________________________________________________________________________________
##______________________________________________________________________________________________________________________________
##______________________________________________________________________________________________________________________________
##______________________________________________________________________________________________________________________________
##__________________________________________________________________________________________xxxxxxxxxxxxxxxxxxxxxxxxxxxxxxxxxxxx
################################################################################################################################
################################################################################################################################
################################################################################################################################
################################################################################################################################


################################################################################################################################
________________________________________________________________________________________##______________________________########
________________________________________________________________________________________##____O_________________________########
________________________________________________________________________________________##______________________________########
________________________________________________________________________________________##___###############^^^^^^^^^^^_########
________________________________________________________________________________________##___###############____________########
________________________________________________________________________________________##___###############________^^__########
________________________________________________________________________________________##___###############____________########
_________________________________________________#########################################___###############________^^__########
____________________________________________###_________________________________________<____###############____________########
#########################################_______________________________________________<____###############________^^__########
________________|_______________________#_______________________________________________####################____________########
________________|_______________________#__O____________________________________________####################________^^__########
________________|_______________________#_______________________________________________####################____________########
________________|_______________________######__######____#######____###________________####################________^^^^_______#
________________|_____________________________________________###____###____^^__________####################^^#^^^____###______#
_____________O__|_____________________________________________###____###________________##_____________#####__#_^^^^^^_________#
________________|______________________#______________________###____###_##________##___##_____________#####^^#^^^^____________#
____________###_|______________________#______________________###____###___________##___##_____________#####__#________________#
________________|__________x_______x___#______________________###____###____^^_____##___##_____________#####^^#________________#
________##______|______#######__####___#______________________###____###___________##___##_____________#####__#__________#_____#
________________|_____________________________________________###____###_______##__##___##_____________X####^^#__________#_____#
___##___________|___##_____________#####______O____________________________________##___######^^#####___X###_____________#_____#
________##______|____________________O______________________________________##_____##____|__________##___X##^^^^^^^^^^^__#_____#
________________|______##_____________________________####___####____####__________##____|____^^____###___X#___________^^#_____r
__________^^____|_____________##rrrrrrrrrrr##xxx##___________####____####__________##____|__________####______x__x__x____#fffff#
________________|__________##_##___________#########_________####____####__________#############################################
xxxxxxxxxx##____|______##__##_##xxxxxxxxxxx##_O_<<<<_______________________________#############################################
################################################################################################################################
################################################################################################################################
################################################################################################################################
################################################################################################################################

________________________________________________________________________________________________________________________________
________________________________________________________________________________________________________________________________
________________________________________________________________________________________________________________________________
________________________________________________________________________________________________________________________________
________________________________________________________________________________________________________________________________
________________________________________________________________________________________________________________________________
________________________________________________________________________________________________________________________________
________________________________________________________________________________________________________________________________
________________________________________________________________________________________________________________________________
________________________________________________________________________________________________________________________________
________________________________________________________________________________________________________________________________
________________________________________________________________________________________________________________________________
________________________________________________________________________________________________________________________________
________________________________________________________________________________________________________________________________
________________________________________________________________________________________________________________________________
________________________________________________________________________________________________________________________________
________________________________________________________________________________________________________________________________
________________________________________________________________________________________________________________________________
________________________________________________________________________________________________________________________________
################################f__^^___________________________________________________________________________________________
###___________________________|_________________________________________________________________________________________________
O##___________________________|____^^___________________________________________________________________________________________
_##_________f____O____f_______|_________________________________________________________________________________________________
_##___________________________|____^^___________________________________________________________________________________________
_R____________________________|_________________________________________________________________________________________________
f##fRRRRRRRR_rrrrrrrrr_RRRRRR########___________________________________________________________________________________________
####xxxxxxxxxxxxxxxxxxxxxxxxx########___________________________________________________________________________________________
#####################################___________________________________________________________________________________________
################################################################################################################################
################################################################################################################################
################################################################################################################################
################################################################################################################################
